--7-2----
-2--156-3
5---3-89-
-547-----
---------
-----945-
-36-5---4
2-819--3-
----7-9--