---72---3
7-5-6---2
---8-1-9-
-7---9---
9---1---4
---4---1-
-4-2-3---
8---4-3-9
2---97---