---5-43--
9-127----
-5--8---6
3---4--7-
5-------2
-7--9---1
2---5--6-
----274-8
--41-9---