----7--4-
---3----9
5-6-8----
-2--4--7-
--82671--
-1--3--8-
----2-7-4
3----6---
-6--5----