-5-9---2-
---8-3---
-2-5--413
-64--52--
28--4--65
--36--17-
648--1-3-
---7-6---
-3---8-5-