13-7--295
5-69-----
--983---1
----2----
----6----
----7----
3---548--
-----74-6
964--1-37